.,-_ '`!?:;­´"()[]<>{}/\*«»‘’‚‛“”„‟…=
а=А
б=Б
в=В
г=Г
д=Д
е=Е
ё=Ё
ж=Ж
з=З
і=І
й=Й
к=К
л=Л
м=М
н=Н
о=О
п=П
р=Р
с=С
т=Т
у=У
ў=Ў
ф=Ф
х=Х
ц=Ц
ч=Ч
ш=Ш
ы=Ы
ь=Ь
э=Э
ю=Ю
я=Я
