;словы якія пачынаюцца на ў, змяняць на у
;дзяйсловы з прыстаўкамі (ёсць у слоўніку)

;Для праверкі
; пільнуеце, будуеце, есці, сесці (пр. час), плоцяць, ;^маўчыць/маўчыце/майчыцё=маўчаць, ^ляціць/леціце/леціцё/ляцяць=ляцець
;^глядзіць/глядзіцё/глядзіце=глядзець

; дзеясловы закончаннага і незакончанага трывання
; спраження дзеяслова будучага часу
;звяжуць - звязаць, узыйдзе, адкажаш - адказаць
;плакаць

13.12.2014
маўчыце,
Баг:
так шукае маўчыце - маўчаць
^2ыце/2у/?ю/2ом/?ём/2ам/?ем/2эш/?еш/2аш/2аце/?яце/?яцё/?еце/2эце/2э/?е/2а/2уць/?юць/2ым/?ім/2ыш/?іш/2ыцё/?іце/?іцё/2ыць/?іць/2аць/?яць=.ць/.аць/.ці/.ыць/.іць/.чы/.уць/.ець/.оць/.іць/.сці/.сьці

так не шукае:
^2у/?ю/2ом/?ём/2ам/?ем/2эш/?еш/2аш/2аце/?яце/?яцё/?еце/2эце/2э/?е/2а/2уць/?юць/2ым/?ім/2ыш/?іш/2ыцё/2ыце/?іце/?іцё/2ыць/?іць/2аць/?яць=.ць/.аць/.ці/.ыць/.іць/.чы/.уць/.ець/.оць/.іць/.сці/.сьці


покет бук бага:

Пры падключэнні PocketBook да кампутара,
покет бук пиша: "Усталявана злученне з ПК", але ноутбук (OpenSuse) не бачыць устройства.

Пасля адлучаешь usb-шнурок ад ноўтбука, праз некалькі хвілін ПокетБук ідзе на перазагрузку.
Пасля перазагрузкі, зноў можна далучыць ПокетБук да ноўта.

астанешся, астануся - астацца
ненавіджу - ненавідзець
дарагое - дарагі
торгнуў - торгнуць
клікнуў - клікнуць
седзячы  - дзеепрыслоўе
людзей - людзі

22.12.2014

07.01.2015
+дзён - дзень
+касцях - косць
+крыві - кровь
+любіў - любіць
імперыю - імперыя
+ядрамі - ядро
+прабіла - прабіць
нашай - наш
трапіла - трапіць (бага, пры пошуку ў тэксце, калі ўводзіць уручную, то знаходзіць)
спадзяецца, 	спадзявацца
+ спадзяюся, 
спадзяешся,
+ спадзеяцеся, 
спадзявайся, 
+ спадзейся,
+ спадзеючыся  - 

+ мяцяжу	мяцеж
найду	найсці
імчаліся	імчацца
раўнінай	раўніна
+ месяцы: жніўня	жнівень
	траўня	травень
	і інш.
+ верасня
снежня - снежань (а не снежны)
алейкай	алейя	алейка

змяншальна-ласкальныя словы:
+ футрачка	футра
+ торба	торбачка
+ лыжка	лыжачка
+ булка	булачка
+ дудка	дудачка
+ папугай	папугайчык
+ дзяўчынка	дзяўчынка
+ кніга	кніжачка, кніжка
+ плямы - пляма (а не пляміць)
+ шыбінак	шыбіна
+ коні	конь, але не кон
+ здаецца - здавацца
+ частавацца
+ асекся	асекчыся
+ асячэцца асячомся асячыся асекчыся
+ спакоі	спакой
+ зор,  зоры	зорка
+ ствалы	ствола
+ дзверы	дзвярэй
+ ялінак	яліна
+ дрэў	дрэва
+ сценах	сцяна (а не сцень)
+ падышоў	падысці
+ ціша,ціш	цішы,цішшу
+ ноччу, мышшу
+ цішыні	цішыня
+ пачалі	пачаць (баг, пры пошуку ў тэксце)
+ ціхія	ціхі (баг)
+ галасы	голас (а не галасіць)
+ прыйшлі	прыйсці (баг)
+ звіняць	звінець
+ чмель	чмялі
+ вуснамі	вусны ( а не вусна)
+ іскры	іскра (а не іскрыць)
+ снягоў	снег
+ плямлю, пляміш	пляміць
+ адбыўся, адбылася, адбыліся адбыцца
спляліся, сплесціся
+ уцёк уцячэ уцякуць уцякла уцякло уцякаць	уцячы


18.01.2015
+ баліць - балець (баг пры пошуку у тэкстах)
+ свеце - свет (не света)
+ пырскам - пырскі (не пырскаць)
дулі - дуля ( не дуць) залежыць ад кантэксту
+ каранях - корань 
+ пачуццю	- пачуццё (не пачуцца)

22.02.2015
+ плыву - плыць
п'ю - піць
+ лью - ліць
+ смейце - смець
+ доме - дом
+ нагамі - нага
ён
+ спробай - спроба
+ прамовай - прамова
+ каровай - карова
+ вачыма - вочы
+ мовай - мова
+ бульбай - бульба
+ віне - віна ( не вініць)
+ госці - госць
+ пальцаў - палец
часе - час (не часць)
+ вачыма - вока
+ дыфармацыі
+ нораваў - нораў
+ пырскам - пырскі

 


































